&# 39;="
dĩ đại khi tiểu=ỷ lớn hiếp nhỏ
nhất địch tam=một đấu ba
không có mãn=không có xong
vừa ra hiện=vừa xuất hiện
đạo:=nói:
đạo :=nói:
bả ngươi làm ách ba=bảo ngươi là câm đâu
ma đạo đích nhân=người trong ma đạo
hoàn theo nê vu đạo ma hữu biệt không|sao|chưa=cho rằng Đạo Ma khác biệt sao
hoàn theo nê vu đạo ma hữu biệt=cho rằng Đạo Ma khác biệt
như vậy bổn a=ngốc như vậy sao
liễu không vi ngoại vật sở nhiễu địa cảnh giới=cảnh giới vô vi không bị ảnh hưởng bởi ngoại vật
vượt qua thiên kiếp đích nhân=người vượt qua thiên kiếp
tình thế sở bức=tình thế bức bách
hữu lễ liễu=có lễ
thâm trường đích tươi cười=tươi cười thâm thúy
thính đứng lên như là=nghe cứ như là
chờ nhất nhị=chờ một chút
tri dĩ tri bỉ=biết người biết ta
chiến lòng của=tâm chiến
ngộ lòng của=tâm ngộ
không chết bất diệt=bất tử bất diệt
lão ngưu cái mũi =lão mũi trâu
thuận ta giả xương, nghịch ta giả vong=thuận ta thì sống, nghịch ta thì chết
hàm huyết phún nhân=ngậm máu phun người
xé trời=phá thiên
minh thương dịch đóa=minh thương dễ tránh
ám tiến nan phòng=ám tiễn khó phòng
cho ta sát=giết cho ta
hảo nam không cân nữ đấu=nam tử không đấu với nữ nhi
bàn tay to ấn=đại thủ ấn
dấu tay=thủ ấn
tiềm có thể=tiềm lực
đế đô|đều|cũng=đế đô
mại tốt giới tiễn=bán được nhiều tiền
máu tươi tứ tiên=máu tươi tung tóe
trương không gió=Trương Vô Phong
trương không mây=Trương Vô Vân
biển mây=vân hải
môn nét mặt=trước cửa
ngạo [thiên|ngày]=ngạo thiên
như vậy hảo=tốt như vậy
hắn đích trong mắt=trong mắt hắn
long tại [thiên|ngày]=long tại thiên
đều là [...]cho là=đều cho là
ma [nhĩ|ngươi] khắc la=Ma Nhĩ Khắc La
như vậy [...]chật vật=chật vật như vậy
tiết [nhật|ngày]=ngày lễ
dạy sẽ=giáo hội
dạy hoàng=giáo hoàng
chủ dạy=chủ giáo
bộ xương khô=khô lâu
nghị sẽ=nghị hội
cao tủng địa bộ ngực=bộ ngực cao vươn ra
vú=ngực
hai vú=bộ ngực 
chủ dạy=chủ giáo
đều=đô
chuông=chung
sẽ=hội
thiên|ngày khiến=thiên sứ
tát nhưng=Tát Đán
vực sâu=thâm uyên
hà chân nói=hà túc đạo
cao xa hoa=cao quý
cao đắt tiền=cao quý
chư cát không sáng=chư cát bất lượng
cũng châu=tinh châu
ngàn đêm=thiên dạ
ngàn hiểu đêm=thiên hiểu dạ